# Hente ut liste fra Gunnar med ikke-sammensatte ord, med affikser, bøyninger
seks	seks
funnet	fun-n-et
løp	løp
dagen	da-g-en
drept	drept
melder	mel-d-er
prosesser	pro-ses-s-er
hvem	hvem
september	sep-tem-ber
fant	fant
sør	sør
deler	de-l-er
hjem	hjem
dager	da-g-er
skjer	skjer
bruker	bru-k-er
hvite	hvi-te
figur	fi-gur
mente	men-te
stedet	ste-d-et
brukt	brukt
hvorfor	hvor-for
bergen	ber-gen
gammel	gam-mel
rekke	rek-ke
lederen	le-de-r-en
kommune	kom-mu-ne
data	da-ta
bra	bra
stille	stil-le
vist	vist
vanlig	van-lig
kjente	kjen-te
årene	å-r-e-ne
system	sys-tem
riktig	rik-t-ig
mor	mor
gode	go-de
tro	tro
innen	in-nen
arbeid	ar-be-id
enkelt	en-kelt
vite	vi-te
fall	fall
sterkt	sterkt
gruppe	grup-pe
synes	sy-n-es
kvinner	kvin-n-er
ønsket	øns-k-et
trekke	trek-ke
penger	pen-g-er
løsning	løs-ning
visste	vis-s-te
venstre	venst-re
holder	hol-d-er
følger	føl-g-er
ventet	ven-t-et
gjerne	gjer-ne
endelig	en-de-lig
behov	be-hov
mine	mi-ne
klare	kla-re
bjugn	bjugn
sju	sju
verdi	ver-di
helst	helst
gro	gro
best	best
stand	stand
kjøre	kjø-re
fullt	fullt
bedt	bedt
parti	par-ti
betro	be-tro
gehør	ge-hør
bifall	bi-fall
farlig	far-lig
fredelig	fre-de-lig
alene	a-le-ne
doven	do-ven
røyke	røy-ke
elefant	e-le-fant
mahogni	ma-hog-ni
sitte	sit-te
angre	ang-re
vanske	vans-ke
vindu	vin-du
ørske	ørs-ke
hustru	hust-ru
makrell	mak-rell
appelsin	ap-pel-sin
mandarin	man-da-rin
orangutang	o-ran-gu-tang
buddhisme	bud-dh-is-me
sport1	sport1